0,0,0,0,0,0,0,0,0,0,0,0,0,0,0,0,0,0,0,0,0,0,0,0,0,0,0
14,0,0,0,0,0,0,0,0,0,0,0,0,0,0,0,0,0,0,16,2,2,7,2,2,2,0
0,0,0,0,0,23,0,0,0,0,0,0,0,0,0,0,0,0,0,1,1,1,1,1,1,1,0
2,2,0,2,2,2,2,2,2,2,26,0,0,0,0,0,0,0,0,0,0,1,1,1,0,0,0
1,1,0,1,1,1,1,1,1,1,26,0,0,0,0,0,0,0,0,0,0,1,1,1,0,0,0
1,1,0,1,1,1,1,1,0,0,26,0,0,0,0,0,0,0,0,0,0,0,1,1,0,0,0
1,1,0,1,1,1,1,0,0,0,26,0,0,0,0,0,0,0,0,0,0,0,0,0,0,0,0
1,1,0,1,1,1,0,0,0,0,0,0,0,0,0,0,0,0,0,0,0,0,0,0,0,0,0
1,1,0,1,1,0,0,0,0,0,0,0,0,0,0,0,0,0,0,0,0,0,0,0,0,16,0
1,1,0,0,0,0,21,0,0,0,0,0,0,0,0,0,0,0,2,2,2,2,5,2,0,2,2
1,1,1,1,1,2,2,6,2,2,2,2,2,2,2,2,4,4,1,1,1,1,1,1,0,1,1
1,1,16,1,1,1,1,1,1,1,1,1,1,1,1,1,3,3,1,1,1,1,1,1,0,1,1
1,1,0,1,1,1,1,1,1,1,18,1,1,1,1,16,3,3,1,1,1,1,1,1,0,1,1
1,1,0,0,1,1,1,1,1,1,1,1,1,17,1,1,3,3,1,1,1,1,1,1,0,1,1
1,1,0,0,0,0,0,0,1,1,1,1,1,1,1,1,3,3,1,1,1,1,1,1,0,1,1
1,1,0,0,0,0,0,0,0,1,1,1,1,1,1,1,0,0,0,0,0,0,0,0,0,0,0
1,1,0,0,0,0,0,0,0,0,1,1,1,1,1,0,0,0,0,0,0,0,0,0,0,0,0
1,1,0,0,0,0,0,0,0,0,0,0,0,0,0,0,0,0,0,0,0,0,0,0,0,0,0
1,1,0,0,0,0,0,0,0,0,0,0,0,0,21,0,0,0,0,0,0,24,0,23,0,0,0
1,1,0,0,2,2,2,2,2,2,2,2,2,2,2,2,2,2,2,2,2,2,2,2,2,2,2
1,1,0,0,1,1,1,1,1,1,1,1,1,1,1,1,1,1,1,1,1,1,1,1,1,1,1
1,1,0,0,0,0,0,0,0,0,0,0,0,0,0,0,0,0,0,0,0,0,0,0,0,0,0
1,1,0,0,0,0,0,0,21,0,0,0,0,0,0,0,0,0,0,0,0,0,27,27,27,27,0
1,1,2,0,2,2,2,2,2,2,2,2,2,4,4,2,5,2,2,2,2,2,2,2,2,2,2
1,1,1,1,1,1,1,1,1,1,1,1,1,3,3,1,1,1,1,1,1,1,1,1,1,1,1
1,1,1,1,1,1,1,1,1,16,17,1,1,3,3,1,1,18,19,1,1,1,1,1,1,1,1
1,1,1,1,1,1,1,1,1,1,1,1,1,3,3,1,1,1,1,1,1,1,1,1,1,1,1
1,1,1,1,1,1,1,1,1,1,1,1,1,3,3,1,1,1,1,1,1,1,1,1,1,1,1
1,1,1,1,1,1,1,1,1,1,1,1,1,3,3,1,1,1,1,1,1,1,1,1,1,1,1
1,1,1,1,1,1,1,1,1,1,1,1,1,3,3,1,1,1,1,1,1,1,1,1,1,1,1
1,1,1,1,1,1,1,1,1,1,1,1,1,3,3,1,1,1,1,1,1,1,1,1,1,1,1
1,1,1,1,1,1,1,1,1,1,1,1,1,3,3,1,1,1,1,1,1,1,1,1,1,1,1
1,1,1,1,1,1,1,1,1,1,1,1,1,3,3,1,1,1,1,1,1,1,1,1,1,1,1
1,1,1,1,1,1,1,1,1,1,1,1,1,3,3,1,1,1,1,1,1,1,1,1,1,1,1
0,0,0,0,0,0,0,0,0,0,0,0,0,0,0,0,0,0,0,0,0,0,0,0,0,1,1
26,26,26,0,0,0,0,0,0,0,0,0,0,0,0,0,0,0,0,0,26,26,26,26,0,11,1
2,2,2,2,6,6,6,2,2,2,2,2,2,2,18,2,2,2,2,2,2,2,2,2,2,2,2
1,1,1,1,1,1,1,1,1,1,1,1,1,1,1,1,1,1,1,1,1,1,1,1,1,1,1
0,0,0,0,0,0,0,0,0,0,0,0,0,0,0,0,0,0,0,0,0,0,0,0,0,0,1
0,0,24,0,0,0,0,0,0,0,0,0,0,27,0,0,0,0,0,0,0,0,0,0,25,0,1
1,1,1,1,1,1,1,1,1,1,1,0,1,1,0,1,1,0,1,1,1,1,1,1,1,1,1
0,0,0,0,0,1,1,1,1,1,1,0,1,1,0,1,1,0,1,1,1,1,1,1,1,1,1
0,0,0,0,0,1,1,1,1,1,1,0,1,1,0,1,1,0,1,1,1,1,1,1,1,1,1
0,0,0,0,0,1,0,0,0,0,0,0,1,0,0,0,1,0,0,26,26,26,26,0,0,0,1
0,0,0,0,0,1,0,1,1,1,1,1,1,0,1,1,1,1,1,1,1,1,1,1,1,0,1
1,1,1,1,1,1,0,1,1,1,1,1,1,0,1,1,1,1,1,1,1,1,1,1,1,0,1
1,0,0,0,0,0,0,0,0,0,1,0,0,0,0,0,0,0,1,1,1,1,1,1,1,0,1
1,0,1,1,1,1,1,1,1,0,1,27,1,1,1,1,1,0,1,1,1,1,1,1,1,0,1
1,26,26,26,26,0,0,0,1,0,1,27,1,1,1,1,1,0,1,1,1,1,1,1,1,0,1
1,1,1,1,1,1,1,0,1,0,1,27,1,1,1,1,1,0,0,0,1,1,1,1,1,0,1
1,0,0,26,26,26,26,0,1,0,1,27,1,1,1,1,1,1,1,0,1,1,1,1,1,0,1
1,0,1,1,1,1,1,1,1,0,1,27,1,1,1,1,1,1,1,0,1,1,1,1,1,0,1
1,0,1,1,1,0,0,0,0,0,0,0,1,0,0,0,0,0,0,0,0,0,0,0,1,0,1
1,0,1,1,1,0,1,1,1,1,1,0,1,0,1,1,1,1,1,1,1,1,1,1,1,0,1
1,0,1,1,1,0,1,1,1,1,1,0,1,0,1,1,1,1,1,1,0,0,0,0,0,0,1
1,0,1,1,1,0,1,1,1,1,1,0,1,0,0,0,0,0,0,0,0,0,0,27,27,0,1
1,0,1,1,1,0,1,1,1,1,1,0,1,1,1,1,1,1,1,1,1,1,7,1,1,0,1
1,0,0,0,0,0,0,0,0,0,0,0,0,0,0,0,0,0,0,0,0,0,0,0,0,0,1
1,0,25,0,0,0,0,0,0,0,28,28,28,28,0,0,0,0,0,0,0,0,0,0,0,0,1
1,1,1,1,1,1,1,1,1,1,1,1,1,1,1,1,1,1,1,1,1,1,1,1,1,1,1
1,1,1,1,1,1,1,1,1,1,1,1,1,1,1,1,1,1,1,1,1,1,1,1,1,1,1

